Ich bin - ja
Du bist - ty
Es ist - ono
Sie ist - ona
Sie ist - oni
Er ist - on
Scho'<n - ladnie
Gut - Dobrze
Auch - tez
Das ist - to
Herr - господин
Frau - госпожа
Und - i
Es ist - to
Deutschland - niemcy
ein Junge - chlopiec
ein Hund - pies
ein Mann - meszczyzna
ein Freund - kolega
eni Mensch - czlowiek
eine Biene - pszczola
eine Katze - kot
Freundin - kolezanka
eine Frau - pani
eine - jedna
eule - sowa
ein Pferd - kon
ein Kind - dziecko
ein Tier - zwierze
ein Buch - kisazka
ein Ma..<dchen - dziewczynka
